-ers, those who do : taan

Africa : Aberika

America : Amerika

April : Eberi

Asia : Aatia

August : Aokati

Australia : Aotiteeria

Bible : Baibara

Britain : Buritan

Capital town on Tarawa where Government Headquarters are : Bairiki

Catholic Church : Katorika

Church : Ekaretia

Church of God : ana Ekaretia te Atua

Cooperative : Bobooti

December : Ritemba

Ellice (Tuvalu) : Ereti

England : Engiran

February : Beberuare

Fiji : Biti

France : Buranti

Friday : Kanimabong

Gilbert Group : aono ni Kiribati

Gilbertese : I Kiribati

Gilbertese dancing : m'aiee

Gilbertese kind of dancing using short skirts : tiireeree

Gilberts : Kiribati

God : Atua

Government Headquarters : atuun te tautaeka

I (before na, nang(i)) : N

I : I

I don't know : ngkam

January : Tianuare

July : Tuurai

June : Tuun

Kiribati dance (for men) : waanibanga

Kiribati dancing : ruoia

Kiribati stick dancing : karanga

March : Maati

Mass : Tutia

May : Meei

Monday : Moanibong

Mormon Church : Aro ni Momon

Mormon religion, church : Moomon

November : Nobemba

October : Okitoba

Pacific : Betebeke

Protestant Church : Kamatuu

Saturday : Kaonobong

September : Tebetemba

Seventh day : Kaitibong

Solomon : Toromon

Sunday : Taabati

Thursday : Kaabong

Tuesday : Kauabong

Wednesday : Katenibong

a bush : mao

a child : nati

a conference : kaboowi

a cook; a cooker : kuuka

a food : am'arake

a game : takaakaro

a game played with playing cards : roka

a giant : toa

a holiday : motirawa

a kind of game played with playing cards : kabutikai

a lock : roka

a long and broad knife : taaba

a name of a village on Tarawa : Buariki

a paddle : bweennarina

a paddle; a rudder : bwee

a powdered food made from pandanus fruit : kabubu

a question : titiraki

a rat : kimoa

a shoulder : anga

a singing or song : anene

a store : titooa

a toddy; sweet : karewe

a whale : kua

about; perhaps : tao

accident : kabuanib'ai

add to; included : ikotaki

admitting : karinrin

after : imwiin

after him/her/it : imwiina

after you : imwiim

after, result of : mwiin

afternoon : b'akantaai

afternoon : tanimaeaontaai

again : manga

age, generation : roro

ages : rooro

agricultural workers, farmers : taan ununiki

agriculture : unuuniki

air : eea

airplane : waanikiba

all the time, everytime : taai nako

all, altogether : kabane

almost, close to : kaan

almost; : kuri

among them : ibuakoia

an approximate calculation : katautau

ancestor : bakatibu

anchor : roo

and : ao

and, with : ma

animal : man

animal/birds of : manin

animals : maan

appear : ria

army : taanga

aside; apart : okoro

assembly : bootaki

assembly building, public meeting house : m'aneaba

axe (small) : tanai

baby, child, kid : teei

back : buki

back of : bukin

back/center/middle of : nuukan

bad : buaakaka

bad : bubuaka

bait : abea

baked : umunaki

bald : mara

ball : booro

ball bat (kind of game where one group bats the ball and the
other group tries to catch) : oreano

banana : b'anaanaa

bank : bangke

basin : beetin

basket : b'aene

bath : tebotebo

bathe : tebotebo

be at anchor : rooroo

be boss, director, chief : mataniwi

be friends with : raonna

be friends with : raoraona

be given : anganaki

beach : bike

bearing fruit : uaa

beat of : orean

beautiful, pretty, nice looking : tikiraoi

because : bukina

because, for, that, as : b'a

bed : kainiwene

been cut : koreaki

beer : biia

before : im'aain

before : m'aain

before me : im'aaiu

before you : im'aaim

behind, at the back of : akuun

being extracted from coconut (kernel) : katarinaki

believe; to say something or someone is true ; to prove : kakoauaa

bell : beero

below, under : iaan

bend : b'aoua

beside : irarikin

beside, near : rarikin

between : marenan

between them : marenaia

bicycle : b'aatika

big, large : ab'aab'aki

big, large : buubura

bird : mannikiba

bite : tena

bite you : tenaiko

bitter : nii

bitter; healed : mao

black : roroo

black, blue : b'ata

blackboard : burakibooti

bleeding; blood; : raraa

blind (as window blind), curtain : roki

blood vessel : ia

blow; throw : kare

blue : mawaawa

blunt : kabubu

boat : booti

body : rab'ata

boil : kaburoa

boiled : kaburoaki

boiling : buro

bomb : boom

bony fish : ikarii

book : boki

books : booki

border, edge : mataniwi

born : bungiaki

boss, director, chief : mataniwi

both : uaia

bought : kabooaki

bowl : boora

box : baoki

boxing : itauu

boy : ataeinimm'aane

branch of : m'aangan

bread : kariki

breadfruit : mai

break (as stick, pencil, etc.), fracture : m'aoto

break, fracture : m'aoto

brick : buriki

bright, clear : oota

broken : uruakaki

broken : uruaki

broken into tiny pieces : maibiibi

brought : uotaki

brown : buraaun

brush : burati

brush : burati

bubble : buroburo

built, established : kataeki

bunker, battlement : nono

bus : b'ati

business; promotion : karikirake

busy : tabe

busy : tabetabe

buy : kabooa

buy : kabooi

by him/her : irouna

by them : irouia

by us : iroura

by you : iroum

by, of : iroun

call : wetea

call at : moaa

call at; start : moana

called at; started; hit by : moanaki

calm (as calm sea); fine, peaceful : raoi

can, to be able to : konaa

canoe : waa

canoe float (outrigger) : rama

canoe of : waan

capital island of the Gilberts : Tarawa

capsize, overturn : ranga

car : kaa

car or motor bike tire : rab'a

carpenter : kaabentaa

cat : katam'a

catching of : karekean

caught : karekeaki

caulk : au

causeway : kootiueei

cent (money) : tianti

centimeter : tientemiita

chair : kaintekateka

chalk (blackboard pencil) : tiaoka

changed : bitaki

channel, passage to a lagoon : rawa

chase; go for : kaei

cheap : boobete

cheek : taba

chicken : moa

children : ataei

children of : ataein

chilly : kamariri

chin : b'ange

chosen, elected : rineaki

church feast : toa

cigarette : tikareti

cigarette paper made from pandanus leaf : rauara

class (in school) : koraki

clean it : kaitiakia

cleaned : kaitiaki

cleaning of : kaitiakan

clever, skillful : rabakau

climb up, ascend : tam'arakea

climbing of : tam'akan

close, shut : bonota

closed, shut : bonotaki

closed, shut : in

cloth : kunnikai

coat (animal or clothing) : kooti

coconut : ben

coconut husk : ewanin

coconut leaf : baannii

coconut milk : ranniben

coconut tree : nii

coconuts : been

coffee : koobe

cold : kam'aitoro

cold : m'aitoro

collection of : naa

colon (grammar) : koran

colony : korone

colony of : koronen

come back : oki

come here : nakomai

come last : bina

come late, come after : rimwi

come, arrive, be present : roko

composing, composition : otooto

construct : kateitei

construction : kateitei

construction workers : taani kateitei

content of : kanoan

conversation : marooroo

cook : kam'aa

copra : takataka

correct him/her/it; straighten him/her/it : kaetia

correct me; straighten me : kaetai

correct you; put you right : kaetiko

corrugated iron, copper : kaab'a

cough : bekobeko

cough : bekobeko

count money : warem'ane

counting money : warem'ane

countryside : marenaua

couples : taanga

crews of the ship : kaimoa

cricket (game) : kirikiti

cry : tangi

cry at regular time; that can cry; make sound or rings : taatang

cultivate : ribana

curtains : rooki

custom : katei

cut : koro

cut it : koreia

cut it : koroia

cut them; write them : koroi

cut toddy : korokarewe

cut, write : korea

cutting toddy : korokarewe

dark, darkness : roo

day of : bongin

day; night : bong

daylight : ngaina

delicious : kangkang

deliciousness of : kangkangin

deliver : nikira

denoting a wish : bia

descendant : kariki

die : mate

difference; aside; apart : okoro

different : okoro

different or difference : kaokoro

difficult hard : kaangaanga

dig : ke

dig : kena

dinner : am'arake n te tairiki

dirty : baareka

disabled : toabuaka

dislike : rawa

dispersed : b'aranako

divided, cut into : bwenauaaki

do it or make it : karaoia

do shopping : boob'ai

do, make : karaoa

do; make them (things) : karaoi

doctor : taokita

dog : kamea

dollar : taaraa

don't : tai

down : naano

drink : mooi

dripping : maatimtim

driven by means of paddle or rudder : bweenaki

drunk : nimaki

dry : m'au, m'auu

dry : m'auu

ear : taninga

early : moantaai

early : moantaai

early morning : moaningaabong

earring : taabia

earth, ground : aontano

east : mainiku

east of : mainikun

eastern side; : tanimainiku

easy, light : beebete

eat : kana

eat : kang

eaten : kanaki

eating utensils : b'ai n am'arake

edible : kaakanaki

eel : rabono

eel trap : uu

eight (men, women, etc.) (animate) : waniman

eight (stone, books, etc.) (inanimate) : waniua

eighty : wanibwi

elbow : bubua ni bai

election : rinerine

else; more : riki

empire : embaea

end of; point of : tabon

engage in conversation : marooroo

enough, satisfied : ngae

enough; fit : tau

equal in number : toaraoi

equator : ekueetoa

even : toa

evening : moantairiki

evening : tairiki

evening of : tairikin

every other day, leaving off days : taobongiia

exactly, properly : raoi

examination : ukeuke

excel, be superior : rine

exclamation of intensive feeling : auee

eye : mata

eyebrow : ari

face to face : kaaitara

fall : b'aka

fall away, fall out : mm'anako

fallen : kab'akaaki

family, relative : utuu

famous, renowned : atongaki

far, distant : raroa

farewell : kaboo

farewell : karaaure

fast : waekoa

fast : waetata

fast; powerful : m'aaka

father : tama

father, parent : karo

feather : burae ni man

female, woman : aiine

fever : biiua

fever : biwa

field : marae

fifteen : tebwi ma nimaua

fifth; come fifth : kaniiman

file (tool) : mino

fill it : kanoaia

fill up : kaona

filled : kanoaaki

filled with (oil, kerosene, benzine, etc. ) : b'aanaki

find : kunea

finger : tabonibai

fingernail : uki ni bai

finished : bane

fire : ai

firewood : aia

first : moa

first : moan

first : moani

first born child : karimoa

first class/line/row; primary : moanrinan

fish : anaa

fish : iika

fish : ika

fish of : ikan

fish ovaries : bia

fish trap : maa

fishermen : taan akawa

fishing : akawa

fishing net : karaun

five (animate) : niman

five (general) : nimaua

five persons/animals/ small fish, etc : niiman

flies (insect) : naango

floater of : kabetan

flood : ieka

flour : buraawa

fly : nango

flying fish : onauti

fond of : taatangira

foot (measurement) : butu

football : butibooro

footstep : m'aneka

for : bukin

for : ibukin

for him/her/it, because; at the back of him/her/it : ibukina

for them : ibukiia

forehead : ram'a

forget : m'aninga

found : kuneaki

four : aua

four days : abong

four generations : aroro

fourteen : tebwi ma aua

friendly : iraorao

from : mai

from : mairoun

from : man

from : mani

front : moa

front part of : moan

fruit : uaa

fruit : uaanikai

full stop (period) : biriari

full up : on

funnel : tauni mate

gable of house : ram'a

gathering : ikotaki

general assembly : maungatabu

get in, enter : rin

get; catch : karekea

girl : teinnaiine

give opposites : kaaitarai

go before or go ahead of : rimoa

go for; to chase : kaea

go on; progress : waaki

go round, spin : mino

go with you; : iriko

go with, follow, attend : iri

good health : mauri

good, nice : raoiroi

good-bye : ti a boo

gotten : reke

government : tautaeka

governor : koowana

grandfather : tibu to mm'aane

grandpa or grandma : tibu

gravel (small stones) : atama

green : kiriin

green coconut : moimoto

green coconut water : rannimoimoto

group (especially for islands), district : aono

group of islands formerly named Ellice Islands : Tuvalu

group of stones on the reef : naa

grown-up : ikawai

guest, stranger : irua/iriwa

gutter : kainikawaawaa

hair : ia

hair scarf : kabaeanatu

hair; feather : burae

half : itera

half moon : itibong

half of : iteran

half of it : iterana

hammer : aama

hand : bai

happen, become; : riki

happy glad : kukurei

haste : kawaekoa

hat : b'ara

have/has/had; finished : tia

having something inside : kakanoa

having water inside; swampy : neinei

he, she, it : e

head : atuu

head of : atuun

headache : maraki n atuu

healthy : marurung

hear : ongo

heart or mind : nano

hearts : buroo

heavy : rawaawata

held : tauaki

hell (no article) : moone

help : buoka

help : buoki

help me : buokai

help you : buokiko

helped : buokaki

helpful : ibuobuoki

helping : ibuobuoki

here : ikai

hide and seek : ikaraaba

hide and seek : ikaraaba

high tide : iabuti

him/her/it; he, she, it : ngaia

his wife/her husband : kaainabana

his/her child : natina

his/her mind; its meaning : nanona

his/her presence or arrival : rokona

his/her/ its use : boonganana

his/her/its : ana

his/her/its age; growing up : ikawaina

his/her/its catch : konana

his/her/its departure : nakona

his/her/its eyes : matana

his/her/its food : kanana

his/her/its name : arana

his/her/its sibling of same sex : tarin

hit : oreaki

hit with a foot; step on : toua

hit, cost : boo

hold : taua

hold a general assembly : maungatabu

hold of : tauakin

hold, plural verb form of taua : tauu

holy; forbidden; sacred : tabu

hope; expectation : kaantaninga

hospital : oonaoraki

hot : kabuebue

house : auti

house : um'a

house for guest; guest-house, hotel : auti n iruwa

house of bath; bathroom : um'an tebotebo

house of holiness; church : um'an tabu

house of schooling, classroom : um'an reirei

how (something) is done : iraanaki

how far? : raroara

how is it? : uara

how long? : maanra

how many? (for animals) : iraman

how many? : iraua

how to do (a thing) : iranna

how? : kangaa

husking stick : koro

ignored, embarrassed : tanginako

in : inanon

in order that, so that : aonga

inch : inti

independence : inaaomata

indicating immediate past : a

inform me : kaongoraeai

injured : ikoaki

instrument : katangitang

intoxicating drink : manging

invited : kaoaki

island : abam'akoro

island between Abaiang and Butaritari : Marakei

island in the Gilberts between Kuria and Abemama : Aranuka

island in the Gilberts between Tabiteuea and Abemama : Nonouti

island in the Gilberts between Tabiteuea and Tamana : Onotoa

island in the Gilberts between Tarawa and Marakei : Abaiang

island in the Gilberts, east of Kuria and Aranuka : Abemama

island in the central Gilberts : Kuria

island south of Tarawa : Maiana

island west of Nikunau : Beru

islands of : abam'akoron

islet : atim'akoro

itching : ngongo

its border : mataniwiina

its cigarette paper (rauara) : rauarana

its content : kanoana

its end, point : tabona

its flesh : irikona

its fruit : uaana

its leaf : baana

its part : m'akorona

its people; owner; occupier : kaaina

its rolling : niirakina

its rolling cord (coconut spathe rolling string) : niirana

its sail : iena

its shell : ibuna

its stick, its wood; : kaina

its thatch : rauna

its tobacco : baakeena

its water : ranna

its window : kamaamana

its/his/her bait : abeana

join : tomai

join together (as short pieces of string) : reireiti

jump, fly : kiba

junction : tuta ni kawai

just : tib'a

keel : kabi

keen to eat : kaakang

keep : nano

keep aching, used to aching : mamaraki

keep standing : teei

keep them, look after them : kawakiniia

kept longer : kamaanaki

kerosene : karatiin

kill : kamatea

kilometer : kiromiita

kind of Kiribati song mostly sung in a talking manner; chant : katake

kind of fish : amori

kind of shellfish : koikoi

knee : bubua ni wae

knife : biti

knife : naaibi

knife for cutting toddy : katati

knot; bandage : kabae

know : ataa

know : atai

know him/her/it : ataia

lagoon : nama

lagoon side of; western side of : tanrion

lamp; something that gives out light at night : taura

land : aba

land crab : m'anai

lands : aaba

language : taetae

last (year, week, month...) : ae e nako

last born child : bina

last night : ngke e tairiki

late : rimwi

later on : kiriaria

latrine : kainnakotinaniku

launch : raanti

lavalava of : been

layers of canoe planks : rai

lead me, guide me, direct me : kairai

lead you; guide you; direct you : kairiko

leaf of : baan

leg, foot : wae

letter : reta

lie : kewe

lie down : wene

life giving : kamaiu

life; alive : maiu

lift : tabeka

lift it : tabekia

light : oota

lighter (= spark) : tib'aake

lightning : iti

like him/her/it; love him/her/it : tangiria

like you; love you : tangiriko

listen to : ongoraa

live, stay : maeka

lodged up in a tree, etc : newe

lodged up in a tree, etc : newe

long (esp. when something is hanging down) : m'arairai

long : maan

long ago : ngkoa

look at it : taraia

look at them : taraiia

look for; find out : kakaaea

look for; find out : kakaaei

lost : bua

low tide : ora

lucky : rake

lucky, fortunate : kab'aia

made : karaoaki

mail; ferry : meeri

make it crowded; tied; joined : katenaa

make me angry : kaunai

make me feel light, comfortable after eating too much : kawanaai

make them strong : kamatoai

make you angry : kauniko

man; old : mm'aane

many : bati

many : m'aiti

marine training school : reirei ni kaimoa

marked places in the m'aneaba, etc : boti

marriage : iein

marriage : mare

marry : iein

mast : aneang

mat (coconut leaf) : inaai

mat made of pandanus leaves : kie

matches : maatiati

mats made of pandanus leaves : kiie

me, I : ngai

meal taken at noon : katawanou

meal taken in the evening : katairiki

measurement; arrangement : baaire

meat : iriko

meet : kaaitiboo

meet, assemble : bootaki

meter : miita

middle of them : nuukaia

middle; center; back : nuuka

midnight : nuukanibong

midrib of coconut leaf; leaf of plants : baa

mile : maire

milk : miriki

mind of; depth of; meaning of : nanon

mini dress for women, like blouse : tiibuta

minister : minita

minutes : miniti

missionary, pastor : mitinare

mistake : kaairua

mixed (drink/food) : rereaki

molasses (cooked toddy) : kam'aim'ai

money : m'aane

money : m'ane

moon (no article); month : nam'akaina

moonlit : ianimaama

morning : ingaabong

mosquito : maninnara

mosquito net : b'anga

mother : tina

mother of : tinan

motorbike : rebwerebwe

mouth of; peak of; blade (razor, knife, axe, etc.) : wiin

move away (as sound) : tanginako

mug, cup : m'angko

must : riai

my : au

my body : rab'atau

my child : natiu

my cloth : kunnikaiu

my cousin, opposite sex : ai m'aneu

my cousin, same sex : ai tariu

my dress : b'aiu

my eyes : matau

my father : tamau

my friend : raou

my grandparent : tibuu

my hand : baiu

my home : mweengau

my island, my country : abau

my mind : nanou

my mother : tinau

my name : arau

my nephew or niece : ai natiu

my return : okiu

my right hand side : angaataiu

my salary : boou

my sibling of same sex : tariu

my sister/brother (opp. sex sibling) : m'aaneu

my skill, my knowledge : rabakauu

my stomach : birotou

my way/manner of : arou

nail : neera

name : ara

name of : aran

name of a fish : morikoi

name of a nearby Micronesian country (island) : Nauru

name of an island (Ocean Island) : Banaba

name or call them : araniia

named, called : aranaki

neck : roroa

necklace : m'ae

necklace : m'aenroroa

new : boou

news : rongorongo

news of : rongorongoni

newspaper : nutibeeba

next (week, month, year...) : ae e na roko

nine : ruaiua

ninety : ruabwi

noise : karongoaa

none : akea

noon : tawanou

north : meang

north of : meangin

nose : b'aini

not : aki

not : tiaki

not courtesy, offense : matauninga

not yet : tuai

now : ngkai

nurse : neeti

ocean : marawa

ocean side of, eastern side of : tanraken

ocean side or eastern side or shore : tanrake

octopus : kiika

odd, not even : toabuaka

of : n

of : ni

office : aobiti

old language; conversation : taetae ni kawai

old man : unimm'aane

on/over : iaon

on/over it : iaona

one (article) : teuana

one (canoe/ship/boat) : tewaana

one (person/animal/small fish/insect) : temanna

one hundred : tebubua

one stick : teaina

only : ti

only child : rikitemanna

opposite of : kaaitaraan

orange : aoranti

order (things) : kaoi

orders : kaoaki

our : ara

our child : natira

our names : arara

our weariness : botura

outrigger of a canoe : kiaro

outrigger side of a canoe : raama

outside : tinaniku

outside of : tinanikun

over there : ikekei

pail of or for : kaikan

pail water out of : kaika

pain, ache : maraki

paint : been

painted : beeniaki

pair of shoes : kauu

pale white : maii

pandanus dried pulp : tuae

pandanus leaf : baanikaina

pandanus tree : kaina

pants : kawaerake

panty : tiriwae

paper : beeba

paragraph : b'arakarabe

part : mtakoro

part of : m'akoron

pass : ri

pass time : kakaaki botu

past : rimoa

path, lane, road, street : kawai

pauper : rarikin

pawpaw; papaya : b'aab'aiaa

peace : raoi

pen : been

pencil : bentira

person article for females : Nei

person of, people of; owner of; occupier of : kaain

person. article for males (N. Gilb.) : Nan

person. article for males : Nang

person. article for males; names starting with B or M : Nam

picture : taamnei

picture of : taamnein

pig : beeki

pipe : b'aibi

place; point or end : tabo

places : taabo

plait : bira

plane (tool) : bureen

plant (pl. form of unika) : uniki

plant : aroka

plant : unika

plant : unika

planted : unikaki

plate; record (for record player) : raurau

play cricket : kirikiti

play football : butibooro

play music on any musical instrument; : katangitang

playing card : kaati

playing card game : raami

pleasant : kamaiu

pleasant, pleasing : kakukurei

please : taiaoka

points lost in game : kaiia

poison : boitin

policeman : bureitiman

poor, sad condition : kaawa

port town on Tarawa : Betio

post of : bouan

postpone : taonna

pot : b'ata

potato : buteeta

pour out (water) : kab'aroa

pour out : kab'aroi

power : m'aaka

pray, worship : taromauri

prayer book : boki n tataro

pregnant : bikoukou

preparation : katauraoi

president : beretitenti

press (print) : bwereeti

press : bwereeti

press down; stand or sit on : taonna

pressing down : taotaona

previously, before : kamani

price, cost of : boona

pricked; beaten, (as in a competition) : teke

proper, better; : riai

pumpkin : b'aukin

put it on; divide; put it in : karina

put more fire-wood on the fire : kanaia

put on water to float : kabeta

put on; divided; put in : karinaki

put something on something or somebody : katokaa

put them on; divide; put them in : karin

put, leave behind : katuka

quarter : kuata

quite soft : maraurau

racing : uaia

radio : reerio

rain : karau

read : wareware

read it; count it : warekia

read; count : wareka

reading : wareware

ready : tauraoi

recognize : kinaa

recognize them : kinai

red : uraura

refuse : rawa

relative : koraki

religion : Aro

religions : Aaro

remainder : nikira

remember : uringa

remember it : uringga

replacement of : onean

request you : butiiko

return : oki

return to; come back to : okira

rice : raiti

ride : toka

riding on as in surfing : tokatoka

right hand : angaatai

right there : ikanne

right, correct, straight : eti

rise; show; appear : oti

river : karaanga

rodfishing : roaroa

rolled up : niiraki

room : ruu

rope : roo

rope : roobu

rope tied from mast to outrigger (canoe) : ata

rough, not calm : buaka

row : rinan

rule, govern : tautaeka

rumbling : rurungaa

run : biri

run fast : birim'aaka

run slowly : biri mwere

run, as for vehicles and boats : buti

rusty : raraa

sad : rawaawata

sad, unhappy : nanokaawaki

sail : borau

sail : ie

salt of : taarin

salted : taariaki

same (tiiteboo) : titeboo

same : te boo

saved, rescued, healed : kamaiuaki

saw (tool) : taoo

saw (wood, etc.) : taoo

say : taku

say thus, say as follows : kaangai

scaled : imanaki

scar; decay; sore : maaka

school : reirei

school of nursing : reirei n neeti

scoop it up : itiia

screw : tikuru

sea of : taarin

sea; seawater : taari

second child to him/her : karimwiina

second island in north of Gilberts : Butaritari

second line/class : kauarinan

secondary : kauarinan

see : noora

see : noori

see clearly, understand : oota

see him/her/it : nooria

see you : nooriko

seem : kaanga

seen : nooraki

sell : kabooanako

sent away : kanakoaki

sentence : kibuntaeka

separate : raure

separate, apart : raure nako

set (sun) : bung

seven : itiua

seventeen : tebwi ma itiua

seventy : itibwi

sharp : kakang

sharpen : kakangia

shell fish : bun

shell of : ibun

shell of coconut : ibu

ship : kaibuke

shoe : kauniwae

shoot out, gush out : tii

shopping : boob'ai

short; not long : kimototo

shovel : tiaabora

show them (things) : kaotii

shower of rain : karau tanginako

shower of rain : tanginako

sick, sick person, illness : aoraki

side of : rarikin

side of the road : iteran to kawai

singing with hand covering the ear : tau manin taninga

sit : tekateka

sitting dancing : bino

six (animate) : onoman

six (general) : onoua

sixty : onobwi

size of : ab'akin

skilled : atatai

skin : kun

skin them : kuoti

skinned : kuotaki

sky, heaven : karawa

sleep : matuu

sleep : matuu

slow : waeremwe

slow, late : mweere

small shell fish : koumara

small, tiny : uareereke

smoke (as a fire, etc.) : bubu

smoke (as from fire, etc.) : bubu

smoke (of a pipe, cigar, etc.) : moko

smoke (pipe, cigar, etc.) : moko

smoke made of chipped tobacco and pandanus leaf : moko to rauara

smoke of : mokon

smoke, e.g. from tobacco : tenamoko

soap : toobu

soft (after soaking); wet : mara

soft part of palm of hand : tonotonon to bai

soil of; sand of; earth of : tanoni

some (sticks, etc.) : tabeai

some (things) : tabeua

some : teutana

somebody : tabeman

something like food, etc. prepared for a journey : tianaki

sometimes : tabetai

somewhat soft : marau

song book, hymn book : boki n anene

song of : kunan

sore : kinaka

sort of, kind of : aekan

sort; kind : aeka

sour; drunk : manging

south : maiaki

south of : maiakin

south of it : maiakina

spathe (coconut) : ari

speak : taetae

speak about (pl. of taekina) : taekin

speak about it : taekinna

spear fishing : katebe

spell it : tibeeranna

spread out as mat : taakinaki

stand : tei

standing : teitei

star : itoi

start to grow : riki

stay away of : tikuni

stay, stay away : tiku

stay, to be at a certain place : mena

steering paddle : bweeuru

stick : kai

stick of; wood of : kain

stiff action, kind of Kiribati dancing movement : kaimatoa

stiff; hard, strong : matoa

stockings : titaokin

stomach : biroto

stomachache : maraki ni biroto

stone : atiibu

stop, halt, pause : toki

stop; cure : katoki

straighten; correct : kaeta

strands of : iran

stranger, foreigner : iruwa

strike it; ring it (the bell) : booia

strike, meet (especially for time) : boo

string of : koran

string, cord : kora

strong; big : korakora

stuck : nim

study : kamateb'ai

study : reirei

successive crashing around sounding like thunder : rebwerebwe

such, like (n ai aron) : ai

sun (no article) : taai

sunrise : otintaai

sunset : bungintaai

supper : kamaiu

surface of sea : aontari

surround : katoobibia

surrounded : katoobibiaki

surrounded : otabaniniaki

sweet talking : kareke nano

swell : tibu

table : taibora

take : anaa

take away, to put : kaaki

take away; send away : kanakoi

take from (as food from fire) : aekia

taro : taorooro

taro-like food plant : b'ab'ai

teacher : tia reirei

teachers : taan reirei

teachers' college : reirei n tia reirei

teapot : tiib'aati

tear it; break it (as a glass) : raeuaia

technical institute : reirei ibukini mm'akuri

tell a lie : kewe

tell me : tuangai

ten (people, animals, etc.) : tengaun

ten : tebwina

ten followed by unit : tebwi

thank you (pl.) : kam rab'a

thank you (sing.) : ko rab'a

thanks : rab'a

that : aane

that man : teuaane

that man there : teuaarei

that man who (followed by name or description) : teuaare

that woman/girl : neienne

that woman/girl there : neierei

that yonder : aarei

the biggest island in the Gilberts : Tabiteuea

the doing or making of : karaoan

the eyes of : matan

the fare or freight : kantoka

the home : maeka

the kernel of a green coconut : marai

the last island in the south of Kiribati : Arorae

the look of something/ someone : taraan

the mark or sign; : kanikina

the second island from the south of the Gilberts : Tamana

the traveling : m'am'ananga

the very last island in the north of the Gilberts : Makin

the weaving of : rarangaan

the wind : ang

the, a : te

their : aia

their God : Atuaia

their arrival, their presence : rokoia

their canoe : waaia

their child : natiia

their distances : raroaia

their drink : nimaia

their ears : taningaia

their ends or points : taboia

their entrance, their admittance : riniia

their eyes : mataia

their food : kanaia

their fruits : uaaia

their hands : baiia

their land; land of : abaia

their life : maiuia

their minds/heart/thought : nanoia

their mother : tinaia

their names : araia

their number : m'aitiia

their people : kaaiia

their play : takaakaroia

their sticks; stick for them : kaiia

their thatch (house) : rauia

their thorns (on a pandanus leaf) : m'akeiia

their voice : b'anaaia

their way, their manner : aroia

then : ngkanne

thereby, there is, there are : iai

these : aikai

these men : uaakai

these people : naakai

these things : baika

they : a

thick : matenten

thin : mmanii

thing : b'ai

thing for holding tight, pliers : b'ai ni katena

thing for love, gift, present : b'ai n tangira

thing for sickness, medicine : b'ai n aoraki

thing for unscrewing, screwdriver : b'ai ni kao'ara tikuru

thing of; clothing : b'ain

things : b'aai

things for talking, telephone, speaker : b'aai n taetae

things for working, tools : b'aai ni mm'akuri

think of : iangoa

third island from the south : Nikunau

thirsty : taka

thirty five : tenibwi ma nimaua

this : aei

this : aio

this man : teuaaei

this man who (followed by name or description) : teuaae

this morning : ngke e ingaabong

this woman/girl (usually followed by name) : neie

this woman/girl : neiei

those (far) : akekei

those (things, people, etc.) : taian

those (things, people, etc.) : taiani

those : akanne

those men : uaakanne

those men there : uaakekei

those people : naakanne

those people : naake

those people there : naakekei

those who, -ers (pl. of tia) : taani

thousand : ngaa

three (persons/animals, etc.) : teniman

three (things) : teniua

throat : biibi

thumb : waebua

thus : kaangai

tide : ia

tie (pl of kabaea) : kabaei

tied, bandaged : kabaeaki

tight : koo

timber; woods; sticks; trees : kaai

time of; season : tain

time; clock or watch : tai

times : taai

tiny pieces : maibiibi

tired : kua

tiresome : kakua

to : nakon

to accompany : raonna

to ask him/her, to question him/her : titirakinna

to ask me, to question me : titirakinai

to ask, to question : titiraki

to be bothering : katabetabe

to be jealous : kokookoo

to be patient : taotaona

to beat (as in a competition) : tekena

to become pregnant : kariki

to brush teeth : irewii

to build; to establish : katea

to call out (as to fight); to withdraw : buuta

to carry (plural of uota) : uoti

to cause to fly, jump, leap : kakibaa

to complete : kaboo

to cut it tenderly : maekia

to describe : kab'arab'araa

to describe : kab'arab'arai

to do sitting dance : bino

to drink : nim

to drive; to cause to move something : kabuta

to drop : kab'akaa

to eat : am'arake

to eat/drink; talk fast : kawiitatako

to eat/drink; talk slowly : kawiiremweko

to examine, to test : ukeuke

to exchange : kaaibibiti

to fasten tightly : kakooa

to finish : kabanea

to finish them all : kabanei

to fish : akawa

to flatter : karaanga

to flood : ieka

to fold : kam'anuui

to get something hastily or greedily : kuri

to get to meet at the ends, points : kabooaki

to give : anga

to go closer : kaaniia

to go to : nako

to grate (as coconut) : kautuaa

to grate using shell : koikoi

to have a conference; : kaboowi

to hide in a hole : b'anga

to him/her/it : nakoina

to hoist : irakea

to hold to one's body : rab'ata

to hope for; expect : kaantaninga

to hurry : kawaekoa

to kneel : katorobubua

to leave, rest : motirawa

to leave; to abandon; to go from : kiitani

to make a hole; to bore a hole : kab'angab'angaa

to make a pair : katoaa

to make noise : karongoaa

to make someone busy : katabea

to mark or sign : kanikinaea

to mean something : nanonna

to measure; to make arrangement : baairea

to paddle : bweennarina

to paddle, steer : bwee

to plant : unuuniki

to play : takaakaro

to pray or a prayer : tataro

to preach : kab'arab'ara

to push : butu

to put down; to get something/somebody down : karuoa

to put someone or something face up : katararakea

to roll it up : niiria

to roll them up : niiri

to rub it : bubuia

to run a thing several times : kabuubuta

to say thankful words : karab'arab'a

to show : katerea

to sing : anene

to sing them : anenei

to skin : kuo(ta)

to smell : aroka

to speak, have a conversation : taetae ni kawai

to stand up : teirake

to steal : kimoa

to stop, halt; cure : katoka

to tell a story; to talk : karaki

to them : nakoiia

to trawl a fishing line : kauaaki

to trick; betray : kam'anea

to try on as dress, etc.; permit : kataua

to use as bait : abeana

to use it : kaboonganaa

to visit : kawara

to wait until the coming of; the time of : karokoa

to wear (sing. form) : b'aina

to wear : b'aini

to wed, to marry : mare

to you : nakoim

tobacco : baakee

tomorrow : ningaabong

too, also; again : naba

tooth brushing : irewii

tooth; mouth : wii

toothache : maraki ni wil

toothpaste : toobu ni irewi

top of (tree, plants and mast) : taberan

top part of the foot : raurau ni wae

torch fishing : kibee

torch fishing : kibee

torch fishing for flying fish : tatae

torch for torch-fishing (for flying fish) : oi n tatae

torch for torch-fishing (on reef) : oi ni kibee

torch light made by rolling dry coconut leaves : oi

towel : taara

town on Tarawa where Central Hospital is located : Bikenibeu

translation of : rairan

travel : m'ananga

traveling, used to traveling : m'am'ananga

trawl fishing; : kauaaki

tried; tempted : kataaki

true, real : koaua

truly : bon

truly : boni

truly! : ai

truth : koaua

try it : kataia

turn : rairaki

turtle : on

turtle chase : tau on

twenty : uabwi

twenty : uangaun

two (general) : uoua

two (leaves) : uabaa

two (people/animals or birds) : uoman

two times; twice : uatai

under : aan

undo, untie : kab'araa

undone : b'ara

undone, untied : kabaraaki

up : eta

up, upward : rake

use : kaboonganai

use of : boonganan

use of : kaboonganaan

use of it, its use : manena

use to battle : bubuaka

use to gather together : bobootaki

used : kaboonganaaki

used to, accustom : tataneiai

useful : boongana

useful : manena

verse of a song or poetry : kibu

very : moan

very : rangi

very big in size : totooa

very dark : rootongitong

village : kaawa

village on Tarawa : Eita

village on Tarawa : Teaoraereke

visit at regular times : rooroko

voice of : b'anaan

vomit : mumuta

vomit : mumuta

wait : taninga

wait for (someone) : tataningaa

wait for him/her/it : taningaia

wait; keep waiting : tataninga

walk : nakonako

walk fast : waekoa

walk slowly : waeremwe

wall of : oon

wall, enclosure, pen : oo

want me; like me; love me : tangirai

want, wish : kan

want; like; love : tangira

want; wish : kani

wash : uaati

wash one's face : kabururu

water : ran

wave : nao

waves : naao

waves of : naon

way, manner : aro

way/manner of : aroni

way/manner of; like (n ai aron) : aron

we : ti

weak, feeble : mamàara

weariness, fatigue : botu

weave : raranga

weaving : raranga

week : wiiki

week of : wiikin

welcome : butim'aai

well : m'anib'a

west : maeao

west of : maeaon

west of them : maeaoia

wet : m'aim'ai

what ... doing? : aera

what day? : kairabong

what things? : baikara

what? : teraa

wheel barrow : wiib'ara

when : ngke

when, if : ngkana

when? : nningai

where to? : nakea

where? : engaa

where? : iaa

where? : ngaa

which (near) : ae

which were; that are : ake

white : mainaina

white people; Europeans : I Matang

who, which; that (yonder) : are

who; which : aika

wide or broad : ata

wide, broad : raababa

wife of or husband of : buun

wife or husband : buu

wife or husband : kaainabau

will (future) : na

will, about to (future) : nang

withered : rai

word : taeka

word for calling the attention of more than one person : naaka

word of; news of : taekan

word to call a man's or boy's attention : Nao

word used to call a female's attention : Neiko

words or news about him//her/it : taekana

work : mm'akuri

work : mm'akuri

worn, used : b'ainaki

wounded person : ikoaki

woven : rarangaaki

wrestle : kaunrab'ata

wrestling : kaunrab'ata

write : koroboki

wrong; a mistake; a sin : bure

yard : iaati

year : ririki

yellow : babooboo

yes : eng

yesterday : ngkoananoa

you (pl.) : ngkamii

you (sing) : ngkoe

you : kam

you : ko

young coconut tree : uto

your (pl.) : amii

your (pl.) islands; your (pl.) countries : abamii

your (pl.) names : aramii

your (sing.) name : aram

your : am

your cloth : kunnikaim

your cry : tangim

your dress (clothing) : b'aim

your fingernail : uki ni baim

your fishing : akawam

your hand : baim

your land; your country : abam

your lavalava : beem

your left-hand side : maingim

your life : maium

your sibling of same sex : tarim

your sister/brother (opp. sex sibling) : m'aanem

your voice : b'anaam